111111111111
1PCCCCCCCCC1
1CCCCCCCCCC1
1CCCCCCCCCC1
1CCCCCCCCCE1
111111111111
