111111111111111111111111111111111111111111111
100000000000000000000000000000000000000000001
100000000000000000000000000000000000000000001
100000000000000000000000000000000000000000001
100000000000000000000000000000000000000000001
10000000000000000000E000000000000000000000001
100000000000000001111111100000000000000000001
100000000000000001000000100000000000000000001
100000000000000001000000100000000000000000001
100001111100000000000000000000000000000000001
100000000100000000000000000000000000000000001
100000000100000000000000000000000000000000001
100000000000000000000000000000000000000000001
100000000000000000000000000000000000000000001
10000000000000000000C000000000001111100000001
100000000000000000000000000000000000100000001
111100000000000000000000000000000000100000001
100011111000000000000000000000000000000000001
100000001000000000000000000000000000000000001
100000001000000000000000000000000000000000001
100000000000000000000000000000000000000000001
100000000000000000000000000000000000000000001
100000000000000000000000000000000000000000001
100000000000000000000000000000000000000000001
10000000000000000000P000000000000000000000001
111111111111111111111111111111111111111111111
