11111111111111111111111111111111111111111111111111111111111
10000000000000000000000000000000000000000000000000000000001
10000000000000000000000000000000000000000000000000000000001
10000000000000000000000000000000000000000000000000000000001
1000000000000000000000000000E000000000000000000000000000001
10000000000000000000000000000000000000000000000000000000001
10000000000000000001111111111111111111000000000000000000001
11000000000000000000000000000000000000000000000000000000001
110C0000000000000000000000000000000000000000000000000000001
11000000000000000000000001000000000000000000000000000000001
1111110000000000000000000100000000000000000000000000C000001
10000000000000000000000001000000000000000000000000000000001
10000000000000000000000001000000000000000000001111111111111
10000000000000000000000001000000000000000000001000000000001
10000000000000000000000001111000000000000000001000000000001
10000000000000000000000000000000000000000000000000000000001
10000000000000000000000000000000000000000000000000000000001
10000000000000000000000000000000000000000000000000000000001
1000000000000000000000000000000000000000000000000C000000001
1000000000C000000000000000000000000000000000000000000000001
10000000000000000000000000000000000000000000001111111000001
10000001111111000000000000000000000000000000000000000000001
10000001001001000000000000000000000000000000000000000000001
10000000001000000000000000000000000000000000000000000000001
10000000001000000000000000000000000000000000000000000000001
10000000001000000000000000000000000000000000000000000000001
1000000000000000111110000000000001111110000000000C000000001
10000000000000001000000000000000000000100000000000000000001
10000000000000001000000000000000000000100000000111110000001
100000C0000000001000000000000000000000100000000000000000001
10000000000000001000000000P00000000000100000000000000000001
10000000000000001000000011111000000000100000000000000000001
11111111111111111111111111111111111111111111111111111111111
