1111111111111
1000000000001
10000C000E001
1100000000001
1000000000001
1000011100001
1000000000001
10P0000000001
1000000000001
1111111111111
